1,1,11,1,11,11,1,11,1,1,1,1,1,1,11
1,4,4,4,4,4,11,11,11,11,1,1,1,11,11
3,4,11,11,11,1,4,4,4,11,1,1,11,11,11
7,11,4,4,11,1,11,11,1,4,1,1,1,1,2
7,11,1,4,1,1,4,1,1,1,4,4,4,4,6
7,1,11,4,4,4,1,1,1,1,1,1,4,1,6
7,1,11,4,4,4,4,11,1,1,1,1,1,1,6
8,3,4,4,11,11,2,3,2,3,11,11,11,11,9
10,8,5,5,3,2,9,8,9,8,3,11,2,9,10
10,10,10,10,8,9,10,10,10,10,8,5,9,10,10